原因	怎么回事	什么意思	什么原因
绑定银行卡	绑卡
失败	有问题	不成功	错误	不一致	不符合	不起	不对	无法	不能
无法	不了
银行卡	工行卡
手机号码	手机号
怎么修改	可以修改吗
客服电话	人工客服电话
信用	征信
免费	不要钱
定位	GPS	Gps	gps
微信	微信号
查询	查看	如何查看	怎么查	查	查查	查下
还款	扣款	还钱
如何	怎么	怎么样
还款结清	结清	还清
一点	部分	没有全部
合同细则日期	还款日期	贷款日期
车贷	买车借款	汽车贷款
无法查看	看不了	不能查阅	文件错误
毛豆车贷	毛豆
优信二手车	优信二手车车贷
美利车车贷	美利车
是多少	怎么算
别人	他人
如何申请	怎么开通	怎么借钱	怎么办理	怎么操作
提前还款	一次还清	一次还完	还全款	结清还款
时间	什么时候
存管账号	可溯账户
注销	解除	取消
利率	利息
开立账户	开户
贷款结清证明	结清证明	还清凭证	还款证明
电脑端	电脑
定期存款	理财产品
冻结	不可用
了吗	了么	怎么样了
工新借	工新贷
新网银行	兴网银行